1111111111111
1A0100M000001
1000011111001
1P0011E0000C1
1111111111111
