1111111111
1P10M000C1
1010110111
1000100001
1AA01A0001
111M111M11
10MC0M00A1
1A11111111
10M00000E1
1111111111
