111111111111111111
1P1C00M0000000M0C1
101110001110001111
10000000ME1A000001
100MM0001110001MM1
1A0000000000M01CA1
111111111111111111
